text	tag
 l'information	top 5 stories
 information	top 5 stories
 les nouvelles	top 5 stories
 nouvelles	top 5 stories
 les nouvelles locales	local news
 nouvelles locales	local news
 localesles nouvelles du monde	local news
 nouvelles du monde	international news
 l'actualité internationale	international news
 actualité internationale	international news
Je cherche l'information	top 5 stories
Je cherche information	top 5 stories
Je cherche les nouvelles	top 5 stories
Je cherche nouvelles	top 5 stories
Je cherche les nouvelles locales	local news
Je cherche nouvelles locales	local news
Je cherche localesles nouvelles du monde	local news
Je cherche nouvelles du monde	international news
Je cherche l'actualité internationale	international news
Je cherche actualité internationale	international news
Je voudrais l'information	top 5 stories
Je voudrais information	top 5 stories
Je voudrais les nouvelles	top 5 stories
Je voudrais nouvelles	top 5 stories
Je voudrais les nouvelles locales	local news
Je voudrais nouvelles locales	local news
Je voudrais localesles nouvelles du monde	local news
Je voudrais nouvelles du monde	international news
Je voudrais l'actualité internationale	international news
Je voudrais actualité internationale	international news
J'aimerais l'information	top 5 stories
J'aimerais information	top 5 stories
J'aimerais les nouvelles	top 5 stories
J'aimerais nouvelles	top 5 stories
J'aimerais les nouvelles locales	local news
J'aimerais nouvelles locales	local news
J'aimerais localesles nouvelles du monde	local news
J'aimerais nouvelles du monde	international news
J'aimerais l'actualité internationale	international news
J'aimerais actualité internationale	international news
Je veux l'information	top 5 stories
Je veux information	top 5 stories
Je veux les nouvelles	top 5 stories
Je veux nouvelles	top 5 stories
Je veux les nouvelles locales	local news
Je veux nouvelles locales	local news
Je veux localesles nouvelles du monde	local news
Je veux nouvelles du monde	international news
Je veux l'actualité internationale	international news
Je veux actualité internationale	international news
Je veux lire l'information	top 5 stories
Je veux lire information	top 5 stories
Je veux lire les nouvelles	top 5 stories
Je veux lire nouvelles	top 5 stories
Je veux lire les nouvelles locales	local news
Je veux lire nouvelles locales	local news
Je veux lire localesles nouvelles du monde	local news
Je veux lire nouvelles du monde	international news
Je veux lire l'actualité internationale	international news
Je veux lire actualité internationale	international news
Je voudrais lire l'information	top 5 stories
Je voudrais lire information	top 5 stories
Je voudrais lire les nouvelles	top 5 stories
Je voudrais lire nouvelles	top 5 stories
Je voudrais lire les nouvelles locales	local news
Je voudrais lire nouvelles locales	local news
Je voudrais lire localesles nouvelles du monde	local news
Je voudrais lire nouvelles du monde	international news
Je voudrais lire l'actualité internationale	international news
Je voudrais lire actualité internationale	international news
puis-je lire l'information	top 5 stories
puis-je lire information	top 5 stories
puis-je lire les nouvelles	top 5 stories
puis-je lire nouvelles	top 5 stories
puis-je lire les nouvelles locales	local news
puis-je lire nouvelles locales	local news
puis-je lire localesles nouvelles du monde	local news
puis-je lire nouvelles du monde	international news
puis-je lire l'actualité internationale	international news
puis-je lire actualité internationale	international news
pourrais-je lire l'information	top 5 stories
pourrais-je lire information	top 5 stories
pourrais-je lire les nouvelles	top 5 stories
pourrais-je lire nouvelles	top 5 stories
pourrais-je lire les nouvelles locales	local news
pourrais-je lire nouvelles locales	local news
pourrais-je lire localesles nouvelles du monde	local news
pourrais-je lire nouvelles du monde	international news
pourrais-je lire l'actualité internationale	international news
pourrais-je lire actualité internationale	international news
puis-je avoir l'information	top 5 stories
puis-je avoir information	top 5 stories
puis-je avoir les nouvelles	top 5 stories
puis-je avoir nouvelles	top 5 stories
puis-je avoir les nouvelles locales	local news
puis-je avoir nouvelles locales	local news
puis-je avoir localesles nouvelles du monde	local news
puis-je avoir nouvelles du monde	international news
puis-je avoir l'actualité internationale	international news
puis-je avoir actualité internationale	international news
pourrais-je avoir l'information	top 5 stories
pourrais-je avoir information	top 5 stories
pourrais-je avoir les nouvelles	top 5 stories
pourrais-je avoir nouvelles	top 5 stories
pourrais-je avoir les nouvelles locales	local news
pourrais-je avoir nouvelles locales	local news
pourrais-je avoir localesles nouvelles du monde	local news
pourrais-je avoir nouvelles du monde	international news
pourrais-je avoir l'actualité internationale	international news
pourrais-je avoir actualité internationale	international news
pouvez-vous m'envoyer l'information	top 5 stories
pouvez-vous m'envoyer information	top 5 stories
pouvez-vous m'envoyer les nouvelles	top 5 stories
pouvez-vous m'envoyer nouvelles	top 5 stories
pouvez-vous m'envoyer les nouvelles locales	local news
pouvez-vous m'envoyer nouvelles locales	local news
pouvez-vous m'envoyer localesles nouvelles du monde	local news
pouvez-vous m'envoyer nouvelles du monde	international news
pouvez-vous m'envoyer l'actualité internationale	international news
pouvez-vous m'envoyer actualité internationale	international news
Qu'est qui se passe l'information	top 5 stories
Qu'est qui se passe information	top 5 stories
Qu'est qui se passe les nouvelles	top 5 stories
Qu'est qui se passe nouvelles	top 5 stories
Qu'est qui se passe les nouvelles locales	local news
Qu'est qui se passe nouvelles locales	local news
Qu'est qui se passe localesles nouvelles du monde	local news
Qu'est qui se passe nouvelles du monde	international news
Qu'est qui se passe l'actualité internationale	international news
Qu'est qui se passe actualité internationale	international news
Qu'est qui se arrive l'information	top 5 stories
Qu'est qui se arrive information	top 5 stories
Qu'est qui se arrive les nouvelles	top 5 stories
Qu'est qui se arrive nouvelles	top 5 stories
Qu'est qui se arrive les nouvelles locales	local news
Qu'est qui se arrive nouvelles locales	local news
Qu'est qui se arrive localesles nouvelles du monde	local news
Qu'est qui se arrive nouvelles du monde	international news
Qu'est qui se arrive l'actualité internationale	international news
Qu'est qui se arrive actualité internationale	international news
Qu'elles sont l'information	top 5 stories
Qu'elles sont information	top 5 stories
Qu'elles sont les nouvelles	top 5 stories
Qu'elles sont nouvelles	top 5 stories
Qu'elles sont les nouvelles locales	local news
Qu'elles sont nouvelles locales	local news
Qu'elles sont localesles nouvelles du monde	local news
Qu'elles sont nouvelles du monde	international news
Qu'elles sont l'actualité internationale	international news
Qu'elles sont actualité internationale	international news
