text	tag
 news	news-top-stories
 top 5 stories	news-top-stories
 local news	news-local
 locally	news-local
 world	news-international
 in the world	news-international
 international news	news-local
 sport	sports-top-stories
 top stories of sport	sports-top-stories
 sports	sports-top-stories
 radio	radio-live
 radio one	radio-live
 live radio	radio-live
 music	music-live
 musics	music-live
 radio two	music-live
 live music	music-live
 podcasts	podcasts
I'm looking for news	news-top-stories
I'm looking for top 5 stories	news-top-stories
I'm looking for local news	news-local
I'm looking for locally	news-local
I'm looking for world	news-international
I'm looking for in the world	news-international
I'm looking for international news	news-local
I'm looking for sport	sports-top-stories
I'm looking for top stories of sport	sports-top-stories
I'm looking for sports	sports-top-stories
I'm looking for radio	radio-live
I'm looking for radio one	radio-live
I'm looking for live radio	radio-live
I'm looking for music	music-live
I'm looking for musics	music-live
I'm looking for radio two	music-live
I'm looking for live music	music-live
I'm looking for podcasts	podcasts
I look for news	news-top-stories
I look for top 5 stories	news-top-stories
I look for local news	news-local
I look for locally	news-local
I look for world	news-international
I look for in the world	news-international
I look for international news	news-local
I look for sport	sports-top-stories
I look for top stories of sport	sports-top-stories
I look for sports	sports-top-stories
I look for radio	radio-live
I look for radio one	radio-live
I look for live radio	radio-live
I look for music	music-live
I look for musics	music-live
I look for radio two	music-live
I look for live music	music-live
I look for podcasts	podcasts
I want news	news-top-stories
I want top 5 stories	news-top-stories
I want local news	news-local
I want locally	news-local
I want world	news-international
I want in the world	news-international
I want international news	news-local
I want sport	sports-top-stories
I want top stories of sport	sports-top-stories
I want sports	sports-top-stories
I want radio	radio-live
I want radio one	radio-live
I want live radio	radio-live
I want music	music-live
I want musics	music-live
I want radio two	music-live
I want live music	music-live
I want podcasts	podcasts
I would like news	news-top-stories
I would like top 5 stories	news-top-stories
I would like local news	news-local
I would like locally	news-local
I would like world	news-international
I would like in the world	news-international
I would like international news	news-local
I would like sport	sports-top-stories
I would like top stories of sport	sports-top-stories
I would like sports	sports-top-stories
I would like radio	radio-live
I would like radio one	radio-live
I would like live radio	radio-live
I would like music	music-live
I would like musics	music-live
I would like radio two	music-live
I would like live music	music-live
I would like podcasts	podcasts
Can I have some news	news-top-stories
Can I have some top 5 stories	news-top-stories
Can I have some local news	news-local
Can I have some locally	news-local
Can I have some world	news-international
Can I have some in the world	news-international
Can I have some international news	news-local
Can I have some sport	sports-top-stories
Can I have some top stories of sport	sports-top-stories
Can I have some sports	sports-top-stories
Can I have some radio	radio-live
Can I have some radio one	radio-live
Can I have some live radio	radio-live
Can I have some music	music-live
Can I have some musics	music-live
Can I have some radio two	music-live
Can I have some live music	music-live
Can I have some podcasts	podcasts
Could I have some news	news-top-stories
Could I have some top 5 stories	news-top-stories
Could I have some local news	news-local
Could I have some locally	news-local
Could I have some world	news-international
Could I have some in the world	news-international
Could I have some international news	news-local
Could I have some sport	sports-top-stories
Could I have some top stories of sport	sports-top-stories
Could I have some sports	sports-top-stories
Could I have some radio	radio-live
Could I have some radio one	radio-live
Could I have some live radio	radio-live
Could I have some music	music-live
Could I have some musics	music-live
Could I have some radio two	music-live
Could I have some live music	music-live
Could I have some podcasts	podcasts
I want some news	news-top-stories
I want some top 5 stories	news-top-stories
I want some local news	news-local
I want some locally	news-local
I want some world	news-international
I want some in the world	news-international
I want some international news	news-local
I want some sport	sports-top-stories
I want some top stories of sport	sports-top-stories
I want some sports	sports-top-stories
I want some radio	radio-live
I want some radio one	radio-live
I want some live radio	radio-live
I want some music	music-live
I want some musics	music-live
I want some radio two	music-live
I want some live music	music-live
I want some podcasts	podcasts
I like some news	news-top-stories
I like some top 5 stories	news-top-stories
I like some local news	news-local
I like some locally	news-local
I like some world	news-international
I like some in the world	news-international
I like some international news	news-local
I like some sport	sports-top-stories
I like some top stories of sport	sports-top-stories
I like some sports	sports-top-stories
I like some radio	radio-live
I like some radio one	radio-live
I like some live radio	radio-live
I like some music	music-live
I like some musics	music-live
I like some radio two	music-live
I like some live music	music-live
I like some podcasts	podcasts
I would like some news	news-top-stories
I would like some top 5 stories	news-top-stories
I would like some local news	news-local
I would like some locally	news-local
I would like some world	news-international
I would like some in the world	news-international
I would like some international news	news-local
I would like some sport	sports-top-stories
I would like some top stories of sport	sports-top-stories
I would like some sports	sports-top-stories
I would like some radio	radio-live
I would like some radio one	radio-live
I would like some live radio	radio-live
I would like some music	music-live
I would like some musics	music-live
I would like some radio two	music-live
I would like some live music	music-live
I would like some podcasts	podcasts
I want to read news	news-top-stories
I want to read top 5 stories	news-top-stories
I want to read local news	news-local
I want to read locally	news-local
I want to read world	news-international
I want to read in the world	news-international
I want to read international news	news-local
I want to read sport	sports-top-stories
I want to read top stories of sport	sports-top-stories
I want to read sports	sports-top-stories
I want to read radio	radio-live
I want to read radio one	radio-live
I want to read live radio	radio-live
I want to read music	music-live
I want to read musics	music-live
I want to read radio two	music-live
I want to read live music	music-live
I want to read podcasts	podcasts
I would like to read news	news-top-stories
I would like to read top 5 stories	news-top-stories
I would like to read local news	news-local
I would like to read locally	news-local
I would like to read world	news-international
I would like to read in the world	news-international
I would like to read international news	news-local
I would like to read sport	sports-top-stories
I would like to read top stories of sport	sports-top-stories
I would like to read sports	sports-top-stories
I would like to read radio	radio-live
I would like to read radio one	radio-live
I would like to read live radio	radio-live
I would like to read music	music-live
I would like to read musics	music-live
I would like to read radio two	music-live
I would like to read live music	music-live
I would like to read podcasts	podcasts
Can I read some news	news-top-stories
Can I read some top 5 stories	news-top-stories
Can I read some local news	news-local
Can I read some locally	news-local
Can I read some world	news-international
Can I read some in the world	news-international
Can I read some international news	news-local
Can I read some sport	sports-top-stories
Can I read some top stories of sport	sports-top-stories
Can I read some sports	sports-top-stories
Can I read some radio	radio-live
Can I read some radio one	radio-live
Can I read some live radio	radio-live
Can I read some music	music-live
Can I read some musics	music-live
Can I read some radio two	music-live
Can I read some live music	music-live
Can I read some podcasts	podcasts
Could I read some news	news-top-stories
Could I read some top 5 stories	news-top-stories
Could I read some local news	news-local
Could I read some locally	news-local
Could I read some world	news-international
Could I read some in the world	news-international
Could I read some international news	news-local
Could I read some sport	sports-top-stories
Could I read some top stories of sport	sports-top-stories
Could I read some sports	sports-top-stories
Could I read some radio	radio-live
Could I read some radio one	radio-live
Could I read some live radio	radio-live
Could I read some music	music-live
Could I read some musics	music-live
Could I read some radio two	music-live
Could I read some live music	music-live
Could I read some podcasts	podcasts
Please give me some news	news-top-stories
Please give me some top 5 stories	news-top-stories
Please give me some local news	news-local
Please give me some locally	news-local
Please give me some world	news-international
Please give me some in the world	news-international
Please give me some international news	news-local
Please give me some sport	sports-top-stories
Please give me some top stories of sport	sports-top-stories
Please give me some sports	sports-top-stories
Please give me some radio	radio-live
Please give me some radio one	radio-live
Please give me some live radio	radio-live
Please give me some music	music-live
Please give me some musics	music-live
Please give me some radio two	music-live
Please give me some live music	music-live
Please give me some podcasts	podcasts
Please send me some news	news-top-stories
Please send me some top 5 stories	news-top-stories
Please send me some local news	news-local
Please send me some locally	news-local
Please send me some world	news-international
Please send me some in the world	news-international
Please send me some international news	news-local
Please send me some sport	sports-top-stories
Please send me some top stories of sport	sports-top-stories
Please send me some sports	sports-top-stories
Please send me some radio	radio-live
Please send me some radio one	radio-live
Please send me some live radio	radio-live
Please send me some music	music-live
Please send me some musics	music-live
Please send me some radio two	music-live
Please send me some live music	music-live
Please send me some podcasts	podcasts
Could you give me some news	news-top-stories
Could you give me some top 5 stories	news-top-stories
Could you give me some local news	news-local
Could you give me some locally	news-local
Could you give me some world	news-international
Could you give me some in the world	news-international
Could you give me some international news	news-local
Could you give me some sport	sports-top-stories
Could you give me some top stories of sport	sports-top-stories
Could you give me some sports	sports-top-stories
Could you give me some radio	radio-live
Could you give me some radio one	radio-live
Could you give me some live radio	radio-live
Could you give me some music	music-live
Could you give me some musics	music-live
Could you give me some radio two	music-live
Could you give me some live music	music-live
Could you give me some podcasts	podcasts
Can you give me some news	news-top-stories
Can you give me some top 5 stories	news-top-stories
Can you give me some local news	news-local
Can you give me some locally	news-local
Can you give me some world	news-international
Can you give me some in the world	news-international
Can you give me some international news	news-local
Can you give me some sport	sports-top-stories
Can you give me some top stories of sport	sports-top-stories
Can you give me some sports	sports-top-stories
Can you give me some radio	radio-live
Can you give me some radio one	radio-live
Can you give me some live radio	radio-live
Can you give me some music	music-live
Can you give me some musics	music-live
Can you give me some radio two	music-live
Can you give me some live music	music-live
Can you give me some podcasts	podcasts
Can you send me some news	news-top-stories
Can you send me some top 5 stories	news-top-stories
Can you send me some local news	news-local
Can you send me some locally	news-local
Can you send me some world	news-international
Can you send me some in the world	news-international
Can you send me some international news	news-local
Can you send me some sport	sports-top-stories
Can you send me some top stories of sport	sports-top-stories
Can you send me some sports	sports-top-stories
Can you send me some radio	radio-live
Can you send me some radio one	radio-live
Can you send me some live radio	radio-live
Can you send me some music	music-live
Can you send me some musics	music-live
Can you send me some radio two	music-live
Can you send me some live music	music-live
Can you send me some podcasts	podcasts
Could you send me some news	news-top-stories
Could you send me some top 5 stories	news-top-stories
Could you send me some local news	news-local
Could you send me some locally	news-local
Could you send me some world	news-international
Could you send me some in the world	news-international
Could you send me some international news	news-local
Could you send me some sport	sports-top-stories
Could you send me some top stories of sport	sports-top-stories
Could you send me some sports	sports-top-stories
Could you send me some radio	radio-live
Could you send me some radio one	radio-live
Could you send me some live radio	radio-live
Could you send me some music	music-live
Could you send me some musics	music-live
Could you send me some radio two	music-live
Could you send me some live music	music-live
Could you send me some podcasts	podcasts
Could I read news	news-top-stories
Could I read top 5 stories	news-top-stories
Could I read local news	news-local
Could I read locally	news-local
Could I read world	news-international
Could I read in the world	news-international
Could I read international news	news-local
Could I read sport	sports-top-stories
Could I read top stories of sport	sports-top-stories
Could I read sports	sports-top-stories
Could I read radio	radio-live
Could I read radio one	radio-live
Could I read live radio	radio-live
Could I read music	music-live
Could I read musics	music-live
Could I read radio two	music-live
Could I read live music	music-live
Could I read podcasts	podcasts
Please give me news	news-top-stories
Please give me top 5 stories	news-top-stories
Please give me local news	news-local
Please give me locally	news-local
Please give me world	news-international
Please give me in the world	news-international
Please give me international news	news-local
Please give me sport	sports-top-stories
Please give me top stories of sport	sports-top-stories
Please give me sports	sports-top-stories
Please give me radio	radio-live
Please give me radio one	radio-live
Please give me live radio	radio-live
Please give me music	music-live
Please give me musics	music-live
Please give me radio two	music-live
Please give me live music	music-live
Please give me podcasts	podcasts
Please send me news	news-top-stories
Please send me top 5 stories	news-top-stories
Please send me local news	news-local
Please send me locally	news-local
Please send me world	news-international
Please send me in the world	news-international
Please send me international news	news-local
Please send me sport	sports-top-stories
Please send me top stories of sport	sports-top-stories
Please send me sports	sports-top-stories
Please send me radio	radio-live
Please send me radio one	radio-live
Please send me live radio	radio-live
Please send me music	music-live
Please send me musics	music-live
Please send me radio two	music-live
Please send me live music	music-live
Please send me podcasts	podcasts
Could you give me news	news-top-stories
Could you give me top 5 stories	news-top-stories
Could you give me local news	news-local
Could you give me locally	news-local
Could you give me world	news-international
Could you give me in the world	news-international
Could you give me international news	news-local
Could you give me sport	sports-top-stories
Could you give me top stories of sport	sports-top-stories
Could you give me sports	sports-top-stories
Could you give me radio	radio-live
Could you give me radio one	radio-live
Could you give me live radio	radio-live
Could you give me music	music-live
Could you give me musics	music-live
Could you give me radio two	music-live
Could you give me live music	music-live
Could you give me podcasts	podcasts
Can you give me news	news-top-stories
Can you give me top 5 stories	news-top-stories
Can you give me local news	news-local
Can you give me locally	news-local
Can you give me world	news-international
Can you give me in the world	news-international
Can you give me international news	news-local
Can you give me sport	sports-top-stories
Can you give me top stories of sport	sports-top-stories
Can you give me sports	sports-top-stories
Can you give me radio	radio-live
Can you give me radio one	radio-live
Can you give me live radio	radio-live
Can you give me music	music-live
Can you give me musics	music-live
Can you give me radio two	music-live
Can you give me live music	music-live
Can you give me podcasts	podcasts
Can you send me news	news-top-stories
Can you send me top 5 stories	news-top-stories
Can you send me local news	news-local
Can you send me locally	news-local
Can you send me world	news-international
Can you send me in the world	news-international
Can you send me international news	news-local
Can you send me sport	sports-top-stories
Can you send me top stories of sport	sports-top-stories
Can you send me sports	sports-top-stories
Can you send me radio	radio-live
Can you send me radio one	radio-live
Can you send me live radio	radio-live
Can you send me music	music-live
Can you send me musics	music-live
Can you send me radio two	music-live
Can you send me live music	music-live
Can you send me podcasts	podcasts
Could you send me news	news-top-stories
Could you send me top 5 stories	news-top-stories
Could you send me local news	news-local
Could you send me locally	news-local
Could you send me world	news-international
Could you send me in the world	news-international
Could you send me international news	news-local
Could you send me sport	sports-top-stories
Could you send me top stories of sport	sports-top-stories
Could you send me sports	sports-top-stories
Could you send me radio	radio-live
Could you send me radio one	radio-live
Could you send me live radio	radio-live
Could you send me music	music-live
Could you send me musics	music-live
Could you send me radio two	music-live
Could you send me live music	music-live
Could you send me podcasts	podcasts
What is happening in the news	news-top-stories
What is happening in the top 5 stories	news-top-stories
What is happening in the local news	news-local
What is happening in the locally	news-local
What is happening in the world	news-international
What is happening in the in the world	news-international
What is happening in the international news	news-local
What is happening in the sport	sports-top-stories
What is happening in the top stories of sport	sports-top-stories
What is happening in the sports	sports-top-stories
What is happening in the radio	radio-live
What is happening in the radio one	radio-live
What is happening in the live radio	radio-live
What is happening in the music	music-live
What is happening in the musics	music-live
What is happening in the radio two	music-live
What is happening in the live music	music-live
What is happening in the podcasts	podcasts
what is going on in the news	news-top-stories
what is going on in the top 5 stories	news-top-stories
what is going on in the local news	news-local
what is going on in the locally	news-local
what is going on in the world	news-international
what is going on in the in the world	news-international
what is going on in the international news	news-local
what is going on in the sport	sports-top-stories
what is going on in the top stories of sport	sports-top-stories
what is going on in the sports	sports-top-stories
what is going on in the radio	radio-live
what is going on in the radio one	radio-live
what is going on in the live radio	radio-live
what is going on in the music	music-live
what is going on in the musics	music-live
what is going on in the radio two	music-live
what is going on in the live music	music-live
what is going on in the podcasts	podcasts
